44444444444444444444444444444444444444444444444444
44444444444444444444444444444444444444444444444444
33000000000000000000000000000000000000000000000055
33000000000000000000000000000000000000000000000055
33000000000000000000000000000000000000000000000055
33000000000000000000000000000000000000000000000055
33000000000000000000000000000000000000000000000055
33000000000000000000000000000000000000000000000055
33000P00000000000000000000000000000000000000000055
33000000000000000000000000000000000000000000000055
33111111111111111111110000000000000000000000000055
33111111111111111111130000000000000000000000000055
44444444444444444444430000000000000000000000000055
44444444444444444444440000000000000000000000000055
33000000000000000000000000000000000000000000000055
33000000000000000000000000000000000000000000000055
33000000000000000000000001111000000000000000000055
33000000000000000000000005113000000000000000000055
33000000000000000000000005443000000000000000000055
33000000000000000000000004444000000000000000000055
33000000000000000000000000000000000000000000000055
33000000000000000000000000000000000000000000000055
33000000000000000000000000000000000000000000000055
33000000000000000011110000000000000000022222200055
33000000000000000051130000000001111111111111111155
33000000000000000054430000000005111111111111111155
33000000000000000044440000000005444444444444444444
33000000000000000000000000000004444444444444444444
33000000000000000000000000000000000000000000000055
33000000000200000000000000000000000000000000000055
33000000011111000000000000000000000000000000000055
33000000051113000000000000000000000000000000000055
33000000054443000000000000000000000000000000000055
33000000044444000000000000000000000000000000000055
33000000000000000000000000000000000000000000000055
33000000000000000000000000222200000000000000000D55
33000000000000000000111111111111111111111111111155
33000000000000000000511111111111111111111111111155
33000000000000000000544444444444444444444444444455
33000000000000000000544444444444444444444444444455
33000000000000000000000000000000000000000000000055
33000000000000000000000000000000000000000000000055
33000011110000000000000000000000000000000000000055
33000051130000000000000000000000000000000000000055
33000054430000000000000000000000000000000000000055
33000022220000000000000000000000000000000000000055
33000000000000000000000000000000000000000000K00055
33000000000022220000000000000000000000000000000055
11111111111111111111111111111111111111111111111111
11111111111111111111111111111111111111111111111111