11111111111111111111111111111111111111111111111111
11111111111111111111111111111111111111111111111111
11000000000000000000000000000000000000000000000011
11000000000000000000000000000000000000000000000011
11000000000000000000000000000000000000000000000011
11000P00000000000000000000000000000000000000000011
11000000000000000000000000000000000000000000000011
11000000000000000000000000000000000000000000000011
11000000000000000000000000000000000000000000000011
11000000000000000000000000000000000000000000000011
11111111111111111111110000000000000000000000000011
11111111111111111111110000000000000000000000000011
11111111111111111111110000000000000000000000000011
11111111111111111111110000000000000000000000000011
11000000000000000000000000000000000000000000000011
11000000000000000000000000000000000000000000000011
11000000000000000000000001111000000000000000000011
11000000000000000000000001111000000000000000000011
11000000000000000000000001111000000000000000000011
11000000000000000000000001111000000000000000000011
11000000000000000000000000000000000000000000000011
11000000000000000000000000000000000000000000000011
11000000000000000000000000000000000000000000000011
11000000000000000011110000000000000000022222200011
11000000000000000011110000000001111111111111111111
11000000000000000011110000000001111111111111111111
11000000000000000011110000000001111111111111111111
11000000000000000000000000000001111111111111111111
11000000000000000000000000000000000000000000000011
11000000000200000000000000000000000000000000000011
11000000011111000000000000000000000000000000000011
11000000011111000000000000000000000000000000000011
11000000011111000000000000000000000000000000000011
11000000011111000000000000000000000000000000000011
11000000000000000000000000000000000000000000000011
11000000000000000000000000222200000000000000000D11
11000000000000000000111111111111111111111111111111
11000000000000000000111111111111111111111111111111
11000000000000000000111111111111111111111111111111
11000000000000000000111111111111111111111111111111
11000000000000000000111111111100000000000000000011
11000000000000000000000000000000000000000000000011
11000011110000000000000000000000000000000000000011
11000011110000000000000000000000000000000000000011
11000011110000000000000000000000000000000000000011
11000011110000000000000000000000000000000000000011
11000000000000000000000000000000000000000000K00011
11000000000022220000000000000000000000000000000011
11111111111111111111111111111111111111111111111111
11111111111111111111111111111111111111111111111111